111111111111111111111111111
1000000C0001000000011111111
11111100110100C000000000011
1Re00P001101000000100000011
11110010000100110010C001001
10C0001000000000E0100000011
111111111111111111111111111
