111111111111111111111111111
1000000C0001000000011111111
11111100110100C000000000011
10E00P0P1101000000100000011
111100100E0100111110C001001
10C00010000E0001E1100000011
111111111111111111111111111
