111111111111111111
1000000C0001000001
11111100110100C001
10000P001101000001
111100100001001111
10C0001000000000E1
111111111111111111
